NO ./textures/plaster15_alt_d.png
SO ./textures/wall_1.png
EA ./textures/wall_2.png
WE textures/silent_metall05.png

C 100,100,160
F 15,111,154

111111111111111111111111111
100000000000000000000000001
101000001000001000000000001
100000000000000000000000001
100010001000100000000000001
100000000000000000000000001
10101010N010101000000000001
100000000000000000000000001
100010001001000000000000001
100000000000000000000000001
101000001000010000000000001
100000000000000000000000001
100000000000000000000000001
100000000000000000000000001
100000000000000000000000001
100000000000000000000000001
100000000000000000000000001
100000000000000000000000001
100000000000000000000000001
100000000000000000000000001
111111111111111111111111111
