NO ./textures/plaster15_alt_d.png
SO ./textures/tile_blood04.png
WE textures/silent_metall05.png
EA textures/silent_metall05.png

F 18,18,18
C 89,44,39

11111111111111111
10000000000000001
10100001111110101
1000000000S000001
10001001111110001
10000000000000001
10101010001010101
10000000000000001
10001000100100001
10000000000000001
10100000100001001
10000000000000001
11111111111111111
