NO ./textures/bluestone.png
SO ./textures/colorstone.png
WE textures/greystone.png
EA textures/wood.png

C 155,1000,1602342342344
F 111,111,111


1111111111111111111111111
1000000000000000000000001
1001111111101111111111101
1001000000000000000000101
1001000000000000000000101
10000000000W0000000000001
1001000000000000000000101
1001000000000000000000101
1001000000000000000000101
1001111111101111111111101
1000000000000000000000001
1111111111111111111111111