NOa ./textures/bluestone.png
SO ./textures/colorstone.png
EA textures/wood.png
WE textures/greystone.png

d 155,100,160
F 111,111,111





1111111111111111111111111
1000000000000000000000001
1001111111101111111111101
1001000000000000000000101
1001000000000000000000101
1000000000000000000000001
1001000000000000000000101
1001000000000000000000101
1001000000000000000000101
1001111111101111111111101
1000000000000000000000001
1111111111111111111111111






