NO ./textures/wall_1.png
EA textures/wall_2.png
SO ./textures/wall_3.png
WE textures/wall_4.png

C 155,100,160
F 111,111,111

1111111111111111111111111
1000000000000000000000001
1011111111110111111111101
1010000000000000000000101
1010000000000000000000101
100000000000N000000000001
1010000000000000000000101
1010000000000000000000101
1011111111110111111111101
1000000000000000000000001
1111111111111111111111111
