NO ./textures/wall_1.png
EA textures/wall_2.png
SO ./textures/wall_3.png
WE textures/wall_4.png

C 155,100,160
F 111,111,111

1111111111111111111111111
1000000000000000000000001
101111111111N111111111101
101        101        101
101        101        101
101        101        101
101        101        101
1011111111110111111111101
1000000000000000000000001
1111111111111111111111111




