NO ./textures/plaster15_alt_d.png
SO ./textures/tile_blood04.png
WE textures/silent_metall05.png
EA textures/silent_metall05.png

F 18,18,18
C 89,44,39

1111111111111111111111111
1000000000111000000000001
1000000000000000000000001
10000000000N0000000000001
1000000000000000000000001
1111111111111111111111111
