NO ./textures/bluestone.png
SO ./textures/colorstone.png
WE textures/greystone.png
EA textures/wood.png

C 155,100,160
F 111,111,111


1111111111111111111111111
1000000000111000000000001
1000000000000000000000001
10000000000N0000000000001
1000000000000000000000001
1111111111111111111111111
