NO ./textures/bluestone.png
SO ./textures/colorstone.png
EA textures/wood.png
WE textures/greystone.png

C 155,100,160
F 111,111,111





1111111111111111111111111
1000000000000000000000001
1011111111111111111101101
1010000000000000000000101
1010000000000000000000001
1010000000000000000000101
10100000000S0000000000101
1000000000000000000000101
1010000000000000000000101
1011011111111111111111101
1000000000000000000000001
1111111111111111111111111




