NO ./textures/plaster15_alt_d.png
SO ./textures/plaster15_alt_d.png
WE textures/plaster15_alt_d.png
EA textures/plaster15_alt_d.png

F 18,18,18
C 89,44,39

1111111111111111111111111
1000000000000000000000001
1011111111111111111111101
101                   101
101                   101
101                   101
1011111111111111111111101
100000000000E000000000001
1111111111111111111111111
