
NO ./textures/wall_1.png
SO ./textures/wall_1.png
EA ./textures/wall_1.png
WE ./textures/wall_1.png

C 155,100,160
F 111,111,111

111111
1 1111
110111
111111
1N1111
111111
