
NO ./textures/wall_4.png
SO ./textures/wall_4.png
EA ./textures/wall_4.png
WE ./textures/wall_4.png

C 155,100,160
F 111,111,111
1111111
1111111
11 1111
1101111
1111111
11N1111
1111111
